00000000000000000000000000000000000000000000000000000000000000000000000000000000000000000000000000000000000000000000000000000000000000000000000000000000000
00000000000000000000000000000000000000000000000000000000000000000000000000000000000000000000000000000002222000220002200022000220002200022000220000000000022
00000000000000000000000000000000000000000000000000000000000000000000000000000000000000022222222220000000000000000000000000000000000000000000000000000000211
00000000000000000000000000000000000000000000000000000000000000000000000000000000000000211111111112000000000000000000000000000000000000000000000000000000111
00000000000000000000000000000000000000000000000000000000000000000000000000000000000002111111111111200000000000000000000000000000000000000000000000000000111
20000000000000000000000000000000000000000000000000000000000000000000000000000000000021111111111111120000000000000000000000000000000000000000000000000000111
10000000000000000000000000000000000000000000000000000000200000000000000000000000000211111111111111112000000000000000000000000022222222220000000000000000111
12222222222222222222222222222222222222222222222222222002122220002222222222222222222111111111111111111222222222222222222222222211111111112222222222222222111
11111111111111111111111111111111111111111111111111111001111112001111111111111111111111111111111111111111111111111111111111111111111111111111111111111111111
11111111111111111111111111111111111111111111111111111001111111001111111111111111111111111111111111111111111111111111111111111111111111111111111111111111111
11111111111111111111111111111111111111111111111111111001111111001111111111111111111111111111111111111111111111111111111111111111111111111111111111111111111
11111111111111111111111111111111111111111111111111111000011100001111111111111111111111111111111111111111111111111111111111111111111111111111111111111111111
11111111111111111111111111111111111111111111111111111000000000001111111111111111111111111111111111111111111111111111111111111111111111111111111111111111111